0000000000000000
0000000000000000
0000000000000000
0000000000000000
0000000000000000
0000000000000000
0000000000000000
0100110000000100
0001000000100000
0000000000000000
0010000000001100
2010000001000000
0000000000000000
0111111110000100
